Controlling: The process of gathering feedback to ensure that a plan is being properly executed or modified as circumstances change.
Financial Accounting vs Managerial Accounting (time focus): FA= focuses on the past MA= focuses on the future
Performance Report: A schedule that compares budgeted data to actual data in order to identify and learn from results
Product Leadership: A customer value proposition used by companies like apple (having the best products is how they attract customers)
Business Process: A series of steps followed in order to carry out come task in business
Corporation Governance: The system by which a company is directed and controlled
Selling costs: Can be either direct or indirect
High-Low Method: (highest unit-lowest unit)/(highest price-lowest price) to change in cost / change in activity
Fixed costs per unit: Increases as production decreases (and vice versa)
Cost Equation: Y=a + bX
Y (mixed costs): Dependent
a (fixed costs): Fixed costs
b (variable costs): Variable costs
X (amount/level): Independent
Conversion cost: Direct labor cost + manufacturing overhead cost
Sunk cost: A cost that cannot be avoided because it had already been incurred
Target customers: Should be the focal point of a companies strategies
Cost volume profit graph: Revenue will be above expense when activity exceeds the breakeven point
Breakeven point decreases with: An increase in selling price
Breakeven formula: Breakeven point in units = fixed costs / (selling price - variable costs)
Contribution Margin Ratio: (CM)/Sales or (Sales-Variable Expenses)/Sales
Schedule of Costs of Goods Manufactured: Represents amount of goods COMPLETED during the CURRENT year
Accumulated Depreciation: Debit (depreciation expense is credited)
Closing out underpaid or overspilled MOH: 1. Multiple accounts distributed 2. Directly to COGS
3 Pillars of managerial accounting: Planning, controlling, decision making
Managerial accounting reports do not have to follow: GAAP
Enterprise Risk Management: The process used by a company to identify risks and develop responses to those risks that enable a company to be reasonably assured of meeting its goal
Institute of Management Accountants: Organization that establishes the statement of ethical professional practice for managerial accountants
Operating Excellence: The customer value proposition that focuses on delivery and service faster and at a lower price, and more conveniently
Stakeholders include: Customers, employees, communities, suppliers, stockholders (NOT competitors)
Credible and respectful leaders have the power to: Intrinsically motivate employees
Contribution margin: What remains from the total sales after deducting all the variable expenses
Fixed manufacturing overhead in absorption costing: A product cost
Cost of inventory in variable vs absorption costing: Lower in variable because absorption costing absorbs the fixed costs as well as the variable costs
Common fixed costs: Incurred because of many segments and should not be charged to one individual segment
Main difference between variable and absorption costing: Whether or not fixed manufacturing costs should be included in product costs
Gross margin: Used in reports using absorption costing but not variable costing
Absorption costing is higher when: Production exceeds sales
Variable costing is higher when: Sales are higher than production
Segment breakeven: Traceable fixed expenses / segment CM ratio
Responsibility accounting: Each manager should be held responsible for only that which he or she can control
Self-imposed budgets may result in: Budgetary slack
Budget order: Sales, production, direct labor, cash, IS and BS
Direct labor budget is based on: Required production for the period
Budgets prepared by frontline managers are: More accurate than those prepared by top managers
Materials price variance: The variance that is most useful in assessing the performance of the purchasing department
Balance scorecards include: The satisfaction of the customer because it is under the manager's control
To increase ROI, decrease: Average operating assets
Decrease in average operating assets will result in: Increased operating income
